# MPDId	GEMId	Xis(x:0/y:1)	ADCId	I2C	Pos	Invert

# ------------------------- Chamber J0

# J0:M_0_Y_L (Left) - rigid

3,	0,	1,		0,	0,	9,	1,
3,	0,	1,		1,	1,	7,	1,
3,	0,	1,		2,	2,	5,	1,
3,	0,	1,		3,	3,	3,	1,
3,	0,	1,		4,	4,	1,	1,

# J0:M_1_Y_L - rigid

3,	1,	1,		5,	8,	9,	1,
3,	1,	1,		6,	9,	7,	1,
3,	1,	1,		7,	10,	5,	1,
3,	1,	1,		8,	11,	3,	1,
3,	1,	1,		9,	12,	1,	1,

# J0:M_2_Y_L - rigid

3,	2,	1,		10,	16,	9,	1,
3,	2,	1,		11,	17,	7,	1,
3,	2,	1,		12,	18,	5,	1,
3,	2,	1,		13,	19,	3,	1,
3,	2,	1,		14,	20,	1,	1,

# J0:M_0_X_T (Top) - flex-v1 inverted

4,	0,	0,		4,	0,	7,	1,
4,	0,	0,		3,	1,	5,	1,
4,	0,	0,		2,	2,	3,	1,
4,	0,	0,		1,	3,	1,	1,

# J0:M_1_X_T - flex-v1 inverted

4,	1,	0,		9,	8,	7,	1,
4,	1,	0,		8,	9,	5,	1,
4,	1,	0,		7,	10,	3,	1,
4,	1,	0,		6,	11,	1,	1,

# J0:M_2_X_T - rigid

4,	2,	0,		10,	16,	7,	1,
4,	2,	0,		11,	17,	5,	1,
4,	2,	0,		12,	18,	3,	1,
4,	2,	0,		13,	19,	1,	1,

# J0:M_0_Y_R (Right) - rigid

5,	0,	1,		0,	0,	0,	0,
5,	0,	1,		1,	1,	2,	0,
5,	0,	1,		2,	2,	4,	0,
5,	0,	1,		3,	3,	6,	0,
5,	0,	1,		4,	4,	8,	0,

# J0:M_1_Y_R - rigid

5,	1,	1,		5,	8,	0,	0,
5,	1,	1,		6,	9,	2,	0,
5,	1,	1,		7,	10,	4,	0,
5,	1,	1,		8,	11,	6,	0,
5,	1,	1,		9,	12,	8,	0,

# J0:M_2_Y_R - rigid

5,	2,	1,		10,	16,	0,	0,
5,	2,	1,		11,	17,	2,	0,
5,	2,	1,		12,	18,	4,	0,
5,	2,	1,		13,	19,	6,	0,
5,	2,	1,		14,	20,	8,	0,

# J0:M_0_X_B (Bottom) - rigid

6,	0,	0,		0,	0,	0,	0,
6,	0,	0,		1,	1,	2,	0,
6,	0,	0,		2,	2,	4,	0,
6,	0,	0,		3,	3,	6,	0,

# J0:M_1_X_B - flex-v1 inverted

6,	1,	0,		9,	8,	0,	0,
6,	1,	0,		8,	9,	2,	0,
6,	1,	0,		7,	10,	4,	0,
6,	1,	0,		6,	11,	6,	0,

# J0:M_2_X_B - flex-v1 inverted

6,	2,	0,		14,	16,	0,	0,
6,	2,	0,		13,	17,	2,	0,
6,	2,	0,		12,	18,	4,	0,
6,	2,	0,		11,	19,	6,	0,

# ------------------------- Chamber J1

# J1:M_0_Y_L (Left) - rigid

7,	3,	1,		0,	0,	9,	1,
7,	3,	1,		1,	1,	7,	1,
7,	3,	1,		2,	2,	5,	1,
7,	3, 	1,		3,	3,	3,	1,
7,	3,	1,		4,	4,	1,	1,

# J1:M_1_Y_L - rigid

7,	4,	1,		5,	8,	9,	1,
7,	4,	1,		6,	9,	7,	1,
7,	4,	1,		7,	10,	5,	1,
7,	4,	1,		8,	11,	3,	1,
7,	4,	1,		9,	12,	1,	1,

# J1:M_2_Y_L - rigid

7,	5,	1,		10,	16,	9,	1,
7,	5,	1,		11,	17,	7,	1,
7,	5,	1,		12,	18,	5,	1,
7,	5,	1,		13,	19,	3,	1,
7,	5,	1,		14,	20,	1,	1,

# J1:M_0_X_T (Top) - flex-v2

8,	3,	0,		0,	0,	7,	1,
8,	3,	0,		1,	1,	5,	1,
8,	3,	0,		2,	2,	3,	1,
8,	3,	0,		3,	3,	1,	1,

# J1:M_1_X_T - flex-v2

8,	4,	0,		5,	8,	7,	1,
8,	4,	0,		6,	9,	5,	1,
8,	4,	0,		7,	10,	3,	1,
8,	4,	0,		8,	11,	1,	1,

# J1:M_2_X_T - rigid

8,	5,	0,		10,	16,	7,	1,
8,	5,	0,		11,	17,	5,	1,
8,	5,	0,		12,	18,	3,	1,
8,	5,	0,		13,	19,	1,	1,

# J1:M_0_Y_R (Right) - rigid

9,	3,	1,		0,	0,	0,	0,
9,	3,	1,		1,	1,	2,	0,
9,	3,	1,		2,	2,	4,	0,
9,	3,	1,		3,	3,	6,	0,
9,	3,	1,		4,	4,	8,	0,

# J1:M_1_Y_R - rigid

9,	4,	1,		5,	8,	0,	0,
9,	4,	1,		6,	9,	2,	0,
9,	4,	1,		7,	10,	4,	0,
9,	4,	1,		8,	11,	6,	0,
9,	4,	1,		9,	12,	8,	0,

# J1:M_2_Y_R - rigid

9,	5,	1,		10,	16,	0,	0,
9,	5,	1,		11,	17,	2,	0,
9,	5,	1,		12,	18,	4,	0,
9,	5,	1,		13,	19,	6,	0,
9,	5,	1,		14,	20,	8,	0,

# J1:M_0_X_B (Bottom) - rigid

10,	3,	0,		0,	0,	0,	0,
10,	3,	0,		1,	1,	2,	0,
10,	3,	0,		2,	2,	4,	0,
10,	3,	0,		3,	3,	6,	0,

# J1:M_1_X_B - flex-v2

10,	4,	0,		5,	8,	0,	0,
10,	4,	0,		6,	9,	2,	0,
10,	4,	0,		7,	10,	4,	0,
10,	4,	0,		8,	11,	6,	0,

# J1:M_2_X_B - flex-v2

10,	5,	0,		10,	16,	0,	0,
10,	5,	0,		11,	17,	2,	0,
10,	5,	0,		12,	18,	4,	0,
10,	5,	0,		13,	19,	6,	0,

# ------------------------- Chamber J2

# J2:M_0_Y_L (Left) - rigid

11,	6,	1,		0,	0,	9,	1,
11,	6,	1,		1,	1,	7,	1,
11,	6,	1,		2,	2,	5,	1,
11,	6,	1,		3,	3,	3,	1,
11,	6,	1,		4,	4,	1,	1,

# J2:M_1_Y_L - rigid

11,	7,	1,		5,	8,	9,	1,
11,	7,	1,		6,	9,	7,	1,
11,	7,	1,		7,	10,	5,	1,
11,	7,	1,		8,	11,	3,	1,
11,	7,	1,		9,	12,	1,	1,

# J2:M_2_Y_L - rigid

11,	8,	1,		10,	16,	9,	1,
11,	8,	1,		11,	17,	7,	1,
11,	8,	1,		12,	18,	5,	1,
11,	8,	1,		13,	19,	3,	1,
11,	8,	1,		14,	20,	1,	1,

# J2:M_0_X_T (Top) - flex-v2

12,	6,	0,		0,	0,	7,	1,
12,	6,	0,		1,	1,	5,	1,
12,	6,	0,		2,	2,	3,	1,
12,	6,	0,		3,	3,	1,	1,

# J2:M_1_X_T - flex-v2

12,	7,	0,		5,	8,	7,	1,
12,	7,	0,		6,	9,	5,	1,
12,	7,	0,		7,	10,	3,	1,
12,	7,	0,		8,	11,	1,	1,

# J2:M_2_X_T - rigid

12,	8,	0,		10,	16,	7,	1,
12,	8,	0,		11,	17,	5,	1,
12,	8,	0,		12,	18,	3,	1,
12,	8,	0,		13,	19,	1,	1,

# J2:M_0_Y_R (Right) - rigid

13,	6,	1,		0,	0,	0,	0,
13,	6,	1,		1,	1,	2,	0,
13,	6,	1,		2,	2,	4,	0,
13,	6,	1,		3,	3,	6,	0,
13,	6,	1,		4,	4,	8,	0,

# J2:M_1_Y_R - rigid

13,	7,	1,		5,	8,	0,	0,
13,	7,	1,		6,	9,	2,	0,
13,	7,	1,		7,	10,	4,	0,
13,	7,	1,		8,	11,	6,	0,
13,	7,	1,		9,	12,	8,	0,

# J2:M_2_Y_R - rigid

13,	8,	1,		10,	16,	0,	0,
13,	8,	1,		11,	17,	2,	0,
13,	8,	1,		12,	18,	4,	0,
13,	8,	1,		13,	19,	6,	0,
13,	8,	1,		14,	20,	8,	0,

# J2:M_0_X_B (Bottom) - rigid

14,	6,	0,		0,	0,	0,	0,
14,	6,	0,		1,	1,	2,	0,
14,	6,	0,		2,	2,	4,	0,
14,	6,	0,		3,	3,	6,	0,

# J2:M_1_X_B - flex-v2

14,	7,	0,		5,	8,	0,	0,
14,	7,	0,		6,	9,	2,	0,
14,	7,	0,		7,	10,	4,	0,
14,	7,	0,		8,	11,	6,	0,

# J2:M_2_X_B - flex-v2

14,	8,	0,		10,	16,	0,	0,
14,	8,	0,		11,	17,	2,	0,
14,	8,	0,		12,	18,	4,	0,
14,	8,	0,		13,	19,	6,	0,


# ------------------------- Chamber J3

# J3:M_0_Y_L (Left) - rigid

15,	9,	1,		0,	0,	9,	0,
15,	9,	1,		1,	1,	7,	0,
15,	9,	1,		2,	2,	5,	0,
15,	9,	1,		3,	3,	3,	0,
15,	9,	1,		4,	4,	1,	0,

# J3:M_1_Y_L - rigid

15,	10,	1,		5,	8,	9,	0,
15,	10,	1,		6,	9,	7,	0,
15,	10,	1,		7,	10,	5,	0,
15,	10,	1,		8,	11,	3,	0,
15,	10,	1,		9,	12,	1,	0,

# J3:M_2_Y_L - rigid

15,	11,	1,		10,	16,	9,	0,
15,	11,	1,		11,	17,	7,	0,
15,	11,	1,		12,	18,	5,	0,
15,	11,	1,		13,	19,	3,	0,
15,	11,	1,		14,	20,	1,	0,

# J3:M_0_X_T (Top) - flex-v2

16,	9,	0,		0,	0,	7,	0,
16,	9,	0,		1,	1,	5,	0,
16,	9,	0,		2,	2,	3,	0,
16,	9,	0,		3,	3,	1,	0,

# J3:M_1_X_T - flex-v2

16,	10,	0,		5,	8,	7,	0,
16,	10,	0,		6,	9,	5,	0,
16,	10,	0,		7,	10,	3,	0,
16,	10,	0,		8,	11,	1,	0,

# J3:M_2_X_T - flex-v2

16,	11,	0,		10,	16,	7,	0,
16,	11,	0,		11,	17,	5,	0,
16,	11,	0,		12,	18,	3,	0,
16,	11,	0,		13,	19,	1,	0,

# J3:M_0_Y_R (Right) - rigid

17,	9,	1,		0,	0,	0,	1,
17,	9,	1,		1,	1,	2,	1,
17,	9,	1,		2,	2,	4,	1,
17,	9,	1,		3,	3,	6,	1,
17,	9,	1,		4,	4,	8,	1,

# J3:M_1_Y_R - rigid

17,	10,	1,		5,	8,	0,	1,
17,	10,	1,		6,	9,	2,	1,
17,	10,	1,		7,	10,	4,	1,
17,	10,	1,		8,	11,	6,	1,
17,	10,	1,		9,	12,	8,	1,

# J3:M_2_Y_R - rigid

17,	11,	1,		10,	16,	0,	1,
17,	11,	1,		11,	17,	2,	1,
17,	11,	1,		12,	18,	4,	1,
17,	11,	1,		13,	19,	6,	1,
17,	11,	1,		14,	20,	8,	1,

# J3:M_0_X_B (Bottom) - rigid

18,	9,	0,		0,	0,	0,	1,
18,	9,	0,		1,	1,	2,	1,
18,	9,	0,		2,	2,	4,	1,
18,	9,	0,		3,	3,	6,	1,

# J3:M_1_X_B - flex-v2

18,	10,	0,		5,	8,	0,	1,
18,	10,	0,		6,	9,	2,	1,
18,	10,	0,		7,	10,	4,	1,
18,	10,	0,		8,	11,	6,	1,

# J3:M_2_X_B - flex-v2

18,	11,	0,		10,	16,	0,	1,
18,	11,	0,		11,	17,	2,	1,
18,	11,	0,		12,	18,	4,	1,
18,	11,	0,		13,	19,	6,	1,

